11111111111111111111
10130000101100000001
10010001001100000001
11001010011100000001
14100000101100000001
10010001001100000001
10000000001100000001
10010001001100000001
10100000101100000001
11000000011100000001
11000000000000000001
11000000001100000001
10100000011100000001
10010000101100000001
10000000001100000001
10010000101100000001
14100000011100000001
11001010001100000001
10010031001100000001
11111111111111111111