11111111111111111111
11110011100001113001
11100001108000188801
11000100100000108001
10000108100800000001
10010100100010000001
10110180100010000001
10100010000010000011
10100140000110800011
13101400000110111111
11001000000110000111
10081100000110000011
11000110110010000001
14100010110010006101
10010011100000000101
10010008100808001401
10000100100000100111
11111180100800180831
15000000100000110041
11111111111111111111
