11111111111111111111
15012000000000000001
10001012121212111001
11001001213111000001
10101000000010000001
10001000100010011141
10011001001010040011
10001010010010000021
10014010010011000001
10120001001014100001
10010000101010010101
10021000101110021001
10210000100010000021
10120101001010000011
10010010010010000131
10001001001010021001
10002100031010010001
10000000011012000001
13000000000021000061
11111111111111111111