11111111111111111111
14100000000000000031
10000000000000000001
10000000000000000001
10000000000000000001
10000000010000000061
11100111112221111111
11100111111111111111
10000000000041000001
10100000000000000001
10100000000000000001
13111111111111111001
11111221111300012001
13000000000000000001
10000000000000000001
10000000000000000001
10000000000000000001
10000000001221000001
15000000001221000041
11111111111111111111