11111111111111111111
14100000011000000051
10000000021000000001
11000000012000000011
13100000011000000101
10010000000000001001
10001000000000010001
10000100000000100001
10101000000000010101
10020010000001002001
10101000000000010101
10000010000001000001
10000000000000000001
10000100000000100001
10001000000000010001
10010001000010001001
10100002000020000131
11000001000010000011
14000001600010000041
11111111111111111111